                    +------------------+  
                    |..................|  
            ##      |..................|  
            ##      |..................|  
            ##      |..................|  
     +------##------+..................|  
     |.................................|  
     |.................................|  
     |.................................|  
     |.................................|  
     |.................................|  
     |.................................|  
     |.................................|  
     |..............+------------#-----+  
     |..............|       +----#-----+  
     |..............|       |..........|  
     |..............|       |..........|  
     |..............#########..........|  
     |..............|  ##   |..........|  
     +--------------+  ##   +----------+  
       +---------------##---------------+ 
       |................................| 
      ##................................##
       |................................| 
       +----------------#---------------+ 
                        #                 
